What				 : что?;
When				 : Когда?;
Where				 : Где?;
Who				 : Кто?;
How old				 : Сколько лет?;
Why				 : Почему?;
some				 : некоторый;
any				 : любой;
late				 : поздно;
have				 : иметь,обладать;
always				 : всегда;
usually				 : обычно;
sometimes			 : иногда;
never				 : никогда;
brackets			 : скобки;
near				 : около;
shower				 : душ;
a lot				 : много;
care				 : забота;
i don't care			 :мне всё равно;
novels				 :романы;
you spell			 : ты пишешь;
hate				 : ненавидеть;
sentences			 : предложение(в тексте);
statements			 : заявление;
too				 : слишком;
I too				 : я тоже;
roommate			 : сосед по комнате;
permission			 : разрешение;
possibility			 : возможность;
things				 : вещи;
busy				 : занятый;
anything			 : что-либо,что угодно;
louder				 : громче;
noisy				 : шумно;
pass				 : проходить;
wear				 :носить;
towards				 : к;
task				 : задача;
soon				 : скоро;
waiter				 : официант; 
hurry				 : спешить;
decide				 : решать;
pronunciation			 : произношение;
rent				 : аренда;
arrive				 : приезжать;
improve				 : улучшать;
happen				 : случиться,происходить;
possible			 : вероятный,возможно;
quite				 : совсем,вполне,достаточно;
sure				 : конечно,уверенный,наверняка;
tried				 : пытаться,стараться,попробовать;
tall				 : высокий;
forgive				 : прощать,извиняться;
fault				 : ошибка,вина,недостаток;
explain				 : объяснять,пояснять;
unfortunately			 : к сожалению;
departure			 : отъезд;
journey				 : поездка,путь;
bushe				 : куст,кустарник;
opposite			 : противоположный,напротив,наоборот;
even				 : даже,ещё;
something			 : что-то,нечто,что-нибудь;
clever				 : умный,ловкий,хитрый;
solve				 : решать,решить,разрешать;
without				 : без,не;
assistance			 : помощь;
until				 : пока,до,до тех пор;
let				 : позволять,разрешать;
immediately			 : немедленно,сразу же;
necessary			 : необходимо,нужно;
terrible			 : ужасный,страшный;
truth : правда;
roots : корни;
through : сквозь;
tear : рвать,разрывать;
piece : кусок,часть;
similar : похожий,схожий;
postpone : отложить;
disappoint : разочарованный;
explorer : исследователь,проводник;
honest : честный,порядочный;
also : также;
somebody : кто-то,некто,кто;
possible : возможно,вероятно;
complicate : усложнять,затруднять;
suddenly : внезапно,вдруг,неожиданно;
far away : издалека;
record : запись,протокол,документация;
almost : почти,практически;
soon : скоро;
disappear : исчезнуть,пропадать;
against : от,против;
regret : сожаление,разочарование;
courage : мужество,храбрость,смелость;
still : всё ещё, ещё, до сих пор;
rarely : редко;
seem : казаться;
fence : забор;
laugh : смех;
exactly : точно,именно;
above : над,выше;
bells : колокола;
sure : уверенный,наверняка,конечно;
mean : означать,значить,иметь в виду;
silent : тихий,безмолвный;
instead : вместо,взамен;
bite : кусать,укус;
together : вместе;
earn : зарабатывать;
same : тот же,то же;
require : требуется;
opportunity : возможность;
introduce : представить;
experience : опыт;
from scratch : с чистого листа;
as well as : а также;
brief : краткий,короткий;
particular : особый,конкретный;
mention : упоминание,ссылка;
implement : внедрять,осуществлять,реализовывать;
own : собственный,родной;
independently : самостоятельно;
evolve : развиваться;
already : уже;
propose : предлагать;
pick : выбрать;
useful : полезное,полезно;
promise : обещание;
regret : сожаление;
genuine : подлинный,настоящий;
directly : напрямую,непосредственно,прямо;
aloud : громко,вслух;
express : выражать,показывать;
tricky : сложный,хитрый;
whether : ли;
hesitation : колебание,сомнение,нерешительность;
spot : место,точка,пятно;
on the spot : на месте,без промедления;
clarify : уточнять,объяснять;
approach : подход, метод;
therefore : поэтому,так что, следовательно;
hesitate : колебаться,замешкаться;
interrupt : прерывать,перебивать;
clarify : уточнять,объяснять;
inquire : выяснять,узнавать,уточнять;
concerned : обеспокоенный,заинтересованный;
cheap : дешёвый;
expensive : дорогой;
hope : надежда;
ear : ухо;
nose : нос;
quietly : тихо,спокойно;
head : голова;
native : родной;
of this kind : такого рода;
neighbour : сосед,соседка;
among : среди,из;
intend : намереваться,планировать;
though : хотя,если бы;
intention : намерения,цель;
going to : Собираюсь;
Fell asleep : Заснуть;
At least : По меньшей мере;
Encounter : Сталкиваться;
I have no doubt : Я не сомневаюсь;
As far as : Насколько;
Help yourself : Угощайтесь;
It's up to you : Тебе решать;
What exactly : Что именно;
Unexpectedly : Неожиданно;
Pay attention : Обращать внимание;
By the way : Кстати;
I am all ears : Я весь внимание;
I guess : Наверное;
Constraint : Ограничение;
So fresh : Так свежо;
Articles : Статьи;
Delay : Задерживать;
Run out of : Закончились;
Schedule : Расписание;
Right now : Прямо сейчас;
Several times : Несколько раз;
Have you ever been to : Вы когда-либо были в;
Look for : Искать;
Have you ever : Ты когда-нибудь;
Announced the boarding : Объявлено о посадке;
Cheers : Ваше здоровье;
Appointment : Встреча;
So far : До сих пор;
Pretty often : Довольно часто;
Attend : Посещать;
raise : поднимать;
Wiser : Мудрее;
The older, the wiser : Чем старше, тем мудрее;
Is twice as expensive : Стоит в два раза дороже;
Not as good as : Не так хорош, как;
The more, the better : Чем больше, тем лучше;
Get on well : Хорошо ладят;
It suits you very well : Тебе это очень подходит;
Don't get me wrong : Не поймите меня неправильно;
On the contrary : Напротив;
Take it easy : Не принимайте близко к сердцу;
Bothers : беспокоит;
Beard : Борода;
What does your friend look like : Как выглядит твой друг;
Suits me : Меня устраивает;
Quite : Вполне;
Get broken : сломаться;
Do your best : Постарайся;
Best regards : С наилучшими пожеланиями;
It's a pity : Жаль;
That's unfair : Это нечестно;
It's very kind of you : Это очень любезно с вашей стороны;
Slim : Стройный;
I have a full-time job : У меня есть работа на полный рабочий день;
Part-time : Неполная занятость;
How's it going : Как дела;
Influence : Влияние;
Complain : Жаловаться;
Daily life : Ежедневная жизнь;
Where are you going : Куда ты идешь;
Do me a favour : Окажи мне услугу;
Convenient : Удобный;
I am wondering : мне интересно;
I'd like to know : Я хотел бы знать;
Participate : Участвовать;
Keep going : Продолжать идти;
No one knows it : Никто этого не знает;
No way : Ни за что;
On the one hand, he is right : С одной стороны, он прав;
Make yourself at home : Чувствуйте себя как дома;
On the other hand, he is wrong : С другой стороны, он ошибается;
It costs a fortune : Это стоит целое состояние;
Sooner or later : Рано или поздно;
Hospitality : Гостеприимство;
Are you kidding? : Ты шутишь?;
As soon as possible : Как можно скорее;
Wait for a while : Немного подождать;
I haven't seen you for ages : Я не видел тебя целую вечность;
I'm so excited to see you : Я так рад тебя видеть;
I have plenty of work to do : у меня много работы;
I would love to : Мне очень хотелось бы;
Enjoy : Наслаждаться;
Particularly enjoy : Особенно наслаждайтесь;
That is so kind of you : Это так любезно с твоей стороны;
It's a waste of time : Это пустая трата времени;
I want to take a break : Я хочу сделать перерыв;
Quite : Довольно;
It's quite close : Это довольно близко;
We have a lot in common : У нас много общего;
It goes without saying : Само собой разумеется;
Everything is in order : Все в порядке;
Purpose : Цель;
At the end of : В конце;
Mother tongue : Родной язык;
Delighted : Получивший удовольствие;
Overjoyed : В восторге;
Wander off : Уйти;
Glanced back : Оглянулся назад;
Crowd : Толпа;
All in good time : Всему свое время;
Soft : Мягкий;
Pleasant : Приятный;
Hang : Вешать;
Notice now : Обратите внимание сейчас;
Rotten : Сгнивший;
Below : Ниже;
Exhausted : Измученный;
Exactly : Точно;
It makes no difference : Это не имеет значения;
It doesn't matter : Это не имеет значения;
Don't give up : Не сдавайся;
Don't take it to heart : Не принимай это близко к сердцу;
Within walking distance : В нескольких минутах ходьбы;
Don't be so shy : Не будь таким застенчивым;
That's not fair : Это не справедливо;
I don't mind : я не против;
Bit later : Чуть позже;
Have a look : Взгляни;
exactly : точно;
Cosy : Уютный;
Spacious : Просторный;
Owe : Быть должным;
How much do i owe you : Сколько я вам должен;
What's the matter : В чем дело;
A block of flats : Многоквартирный дом;
Everything : Все;
Smash : Разгромить;
Share : Делиться;
Offensive : Оскорбительный;
It depends : Когда как;
Implicit : Скрытый;
Within : В пределах;
Detests : Ненавидит;
Time of my appointment : Время моего приема;
Household chores : Домашними делами;
At the same time : В то же время;
Beneficial : Выгодный;
Nowadays : Настоящее время;
At least : По меньшей мере;
Day off : Выходной;
Beach towel : Пляжное полотенце;
Very bright : Очень яркий;
Unemployed : Безработный;
Marital status : Семейное положение;
Easy-going : С легким характером;
Commute to work : Добраться до работы;
Ascending : По возрастанию;
Descending : По убыванию;
It fits well : Замечательно подходит;
It suits you : Тебе идет;
Sorry for interrupting you : Извини, что прерываю тебя;
Well, it's getting late : Ну, уже поздно;
Personally, i think it suits you : Лично я думаю, что тебе это подходит;
Are you feeling under the weather : Вы чувствуете себя плохо?;
It's just simple : Это просто;
What time are we landing : В какое время мы приземляемся;
Profession is not in demand : Профессия не востребована;
Pretty confident : Довольно уверенно;
I'll be back in a couple of minutes : Я вернусь через пару минут;
It's worth trying : Стоит попробовать;
She never used to : Она никогда раньше не;
In advance : Заранее;
All in all : В целом;
I failed to : Мне не удалось;
Likewise : Так же;
Likewise : Аналогично;
Refuse : Отказаться;
Borrow : Занимать;
However : Однако;
Argued : Спорил;
Breathtaking : Захватывающий;
Implicit : Неявный;
I was listening carefully : Я внимательно слушал;
Actually : На самом деле;
Hold on : Подожди;
My regards to the family : Мои пожелания семье;
Anything else : Что-нибудь еще;
Heard a noise : Слышал шум;
Knock at the door : Постучи в дверь;
What an encounter : Какая встреча;
I didn't get : Я не получил;
You exceeded the speed limit : Вы превысили скорость;
Did it work : Это сработало?;
Deception : Обман;
Hire : Нанимать;
It's a different matter : Это другое дело;
That's why : Вот почему;
What is going on : Что происходит;
That's exactly what i mean : Вот именно то, что я имею в виду;
You're always welcome : Всегда пожалуйста;
He was promoted : Его повысили в должности;
Approximately : Примерно;
For more than 10 years : Более 10 лет;
I'm a bit nervous : Я немного нервничаю;
I experienced : Я испытал;
Challenges : Проблемы;
It's none of your business : Это не твое дело;
He retired : Он ушел в отставку;
You may assume : Вы можете предположить;
Find common ground : Найдите общий язык;
He is out of breath : Он запыхался;
My alarm didn't go off : Мой будильник не сработал;
Appreciate : Ценить;
It's a pleasure to meet you : Приятно познакомиться;
I have no clue : Я понятия не имею;
I hired to tutor : Я нанял репетитора;
As soon as : Как только;
Apologize : Извиняться;
It's complete nonsense : Это полная чушь;
Sorry, to bother you : Извините, что беспокою вас;
I was really into boxing : Я действительно увлекался боксом;
Frankly speaking : Откровенно говоря;
Unless you listen carefully : Если ты не послушаешь внимательно;
Keep listening : Продолжайте слушать;
Landlord : Арендодатель;
Do you mind if i smoke : Ты не против если я покурю;
Thank you anyway : В любом случае, спасибо;
Thank you in advance : Заранее спасибо;
Take care : Береги себя;
To be alone : Быть в одиночестве;
To get some privacy : Чтобы немного уединиться;
I'll consider that : Я подумаю об этом;
It's better to call a taxi then : Тогда лучше вызвать такси;
Give him a lift : Подвези его;
Tow : Буксир;
Have a nap : Вздремнуть;
Awful : Ужасный;
The thing is that : Дело в том, что;
Have ever : Когда-либо;
Can i try it on : Могу я это примерить;
Come on : Ну давай же;
Take it into account : Примите это во внимание;
Get a refund : Получать возврат;
Express my opinion : Выразить мое мнение;
Can i borrow : Могу ли я одолжить;
Will be able to complete : Сможет завершить;
I can hardly hear you : Я почти не слышу тебя;
Respectively : Соответственно;
What for : Зачем;
Is this seat occupied : Это место свободно;
We are engaged : Мы помолвлены;
Find out : Выяснить;
Drastically : Кардинально;
Deceived by him : Обманута им;
My journey is over : Моё путешествие окончено;
Whose laptop is it : Чей это ноутбук;
Is it necessary for me to wait : Нужно ли мне ждать;
Twice as expensive : В два раза дороже;
Get on well : Хорошо ладят;
Rate : Ставка;
Rate is too high : Ставка слишком высока;
Rotten : Сгнивший;
Fluently : Бегло;
Shares your opinion : Разделяет ваше мнение;
He detests : Он ненавидит;
Household chores : Домашними делами;
I realize : Я осознаю;
Equipment : Оборудование;
Although : Хотя;
Suitcase : Чемодан;